F F F F F F F F F F F F F F F F F F F F F F 
F F F F F F F F F F F F F F F F F F F F F F 
F F F F F F F F F F F F F F F F F F F F F F 
L L L L L L L L L L L L L L L L L L L L L L
S S S S S S S S S S S S S S S S S S S S S S
R R R R R R R R R R R R R R R R R R R R R R 
F F F F F F F F F F F F F F F F F F F F F F 
F F F F F P F F F F F F F F F F F F F F F F 
F F F F F F F F F F F F F F F F F F F F F F 
L L L L L L L L L L L L L L L L L L L L L L
S S S S S S S S S S S S S S S S S S S S S S
R R R R R R R R R R R R R R R R R R R R R R 
F F F F F F F F F F F F F F F F F F F F F F 
F F F F F F F F F F F F F F F F F F F F F F 
F F F F F F F F F F F F F F F F F F F F F F 
L L L L L L L L L L L L L L L L L L L L L L
S S S S S S S S S S S S S S S S S S S S S S
R R R R R R R R R R R R R R R R R R R R R R 
F F F F F F F F F F F F F F F F F F F F F F 
F F F F F F F F F F F F F F F F F F F F F F 
F F F F F F F F F F F F F F F F F F F F F F 
F F F F F F F F F F F F F F F F F F F F F F 
F F F F F F F F F F F F F F F F F F F F F F 
F F F F F F F F F F F F F F F F F F F F F F 
                      
                      
                      
                      
                      
